****************************************************************************************************
*--********************-*********-------------&-------------@----------------------&---------------*
*-*****************************--------------------&-------------------------&---------------------*
*******************************-&----------------------&------------------------------------------**
*******************************--------------------------------------------------------------------*
******************************---------------------------------------------------------------------*
***************************-*-----------------------------------------------------@----------------*
**************************------------------&-----------------------------------------------@------*
*-***********************------------------------------------------------&----@--------------------*
*-***********************--------------------------------------&---@-----@&------------------------*
*--&--******************------------------------------------------@---------------&----------------*
*-----******************---------------------------------------------------------------------*----@*
*-----*****************----------------------------------------------------------------*****-**----*
*-----****************-------------*---&**-----&------------------------------------*--********----*
*-----*************--&------&----***********-------@----------------------&-----****************--**
*----*************--------------**************------------&-------------&----***********************
*----*************--------@---&****************-------------------------------****************---***
*----***********---------------*****************---------------&--&---------*****************----***
*@----**********---------------******************---------------------------******************---***
*----***-**--------------------******************------------&--------------******************-**-**
*--------*--------------------********************--&------&------------------***************----***
***------&-------------------**********************---------&--------------*-****************----***
***--------------------------**********************---------------------***---**************----&-**
***-------&-----------------***********************-----------@--------*****--**************-------*
***-------------------------***********************-------------------******-***************-------*
****------------------------*********************--------------------*******---*************-------*
****-------------------------********************-------------------*********--*************-------*
***--*------------------------*******************---@-&------------**********--************--------*
**----------------------------*******************------------------**********---*********--@-------*
*-----&------------@----------*******************------------------***********--*******------------*
*-----------------------------******-************------------------************---*****----------&-*
*-------------&--------------******---***********------------------************--------------@-----*
*******-----------------------****---@***********------------------************----------&---------*
********---&-------------------*------************--&--------------************--------&-----------*
********----&-------------------------*************----------------************-----------------*--*
********---------------------------------**********--------------&-************--------&-*-*---*****
********-------------------------@--------*********-@-------&------************------**-****---*****
********---------&------------------------************-------------**************--********-----****
*********---------------------&---&-------*************-----------********************-&------@-****
********-&-------------------------------**************-----------********************----------****
********----------------------&----------**************-------------******************-------@-----*
*******----------------------------------**************------------@*****************------@-------*
****-------------------------&---------****************----&--------*****************--------------*
****------------------------------********************---------------****************--------------*
*****------&----------@----------*********************----------------*************----------**----*
*****----------------------------*********************----------------*************----------------*
**-------------------------------********************--------&--------*************----------------*
*------------------------------***********************----------------**************-----------&---*
*-----------&-----------------***********************-----------------**************-&-------------*
*-----------------------&------*********************------------------*************----------------*
*------------------@----------*********************-------------------************-----------------*
*-----------------------------*********************-------------------************-----------------*
*-------------------&--@-------********************------------------*************-----------------*
*-----------------------------&********************------------------*************-----------------*
*------------------------------*******************---------------------***********-----------------*
*------------------------------*******************---------------------***********-----------------*
*----------------@-&--@--------*******************---&------------------***********--------------&-*
*----*-------------&------------*****************&-----------------------**********----------------*
*--****-------------------------*****************------------------------********-----&------------*
*--***-------------------&------*****************------------------------**********--------------&-*
**---*---------------&----------****************----------&--------------**********----------@-----*
*------------------&--------------*************----------------@@-&------*******-**-------------@--*
*------&----&---------------------*************-&------------------------****----------------------*
***--------------------------------************--------------------------*******-*-----------------*
**--*------------------------------************-&-----------------------*************--------------*
*-*-*-----------------------&------************---------------&---&------*************-------------*
**--**-*---------------------------***********----------@---------------**************-------------*
***-****---------------------------***********------------------@-------**************-------------*
*********&-------------------------************------------------&------**************------&------*
*********---@@---------@-----------***********-------------------------**************--------------*
**********-------------------------***--*****----------------------&---*************---------------*
***********------------------------***---****-------------@-----&-----**************---@----------&*
***********-------------------------*-------------------&-------@------*************---------------*
***********-------------------------------------------------------------************------&--------*
************----------------------------&-------------------------------***********----------------*
************------@-&--------------------------**-----------------------**********-----&-----------*
************----------------------------------******-----&--------------**********-----------------*
**************------------------&-------------*****----------------&-----*********-----------------*
**************----------------------------@---*****-----------------------********-----&-----------*
*************---------------------------------*****---------------&---------******-----------------*
**************-----&-----------&-@-----&-------***--------------------------*****-----&----------&-*
**************-------------------------@--------***-----------------------******-------------------*
**************------------&----------------------*------------------------******----------&--------*
**************-----------------------------------*--------&-------------@-******-------------------*
**************-------&--------------------------***-------&------------&--*******------------------*
*************-----------------------------------***---***-----------------*******------------------*
***************--------------------&-------------*-----***----------------********-----------------*
*************-*---------------------------------***---***-------------&---*******-****-------------*
************----------------------------------@-***&--***----&------------***************----------*
************------------@----------&-------------------------------------****************---------&*
************-----------------------------------**--------------&----@----*****************---------*
***********--------------------------@---****--***-@-----------------&-----***************---------*
**********------------------------------***********------------&--------******************---------*
**********----------------------------*************---------------------******************---------*
**********--------------------@------**************&--------------------******************---------*
***********---------&--&-------------**************---------------------*****-************---------*
***********---------------------&----***************-----------------&--****--*************-------&*
************-@&----------------------****************-------------------***----************&-------*
*************-----------------------*****************----@-@------------*****---***********----&---*
****************************************************************************************************
