****************************************************************************************************
*--------------------------------@----*****************---**************-------------------&-------*
*------&-----------------&------*-----**************-------**************------------@-------------*
*----------------------------**-----&--************--------***************-------------------------*
*---------------------------***-------*************--------***************-@-----------------------*
*-------------@-------------****-------***********----&-----**************------------------------&*
*---------------------------**---------***********-----------**************---------&--------------*
*--------------------------------------**********-----------******************---------------------*
*@--------------------------**---&***************------------******************---------&---&------*
*---------------------------***--****************------------*****************&--&------------**---*
*---------------------------**********************----------*******************---------------******
*-----------------------------*--*****************---------********************--*----------********
*-----------------------------&---*****************-------**************************---*************
*----------&-------&-------------@---**************-------*************************---**************
*---&----------------------------------************------*************************----**************
*--*-@------------------------&-&------*************------**********************------**************
*-**------------------------------------**************----***********************-----**************
*-****--*--------------------------------*************-----*******************--*&----@*************
*-**********-----------------------------*************-@----*****************@----@----*************
*-***********--------------&-------------***************----*****************----------*************
*************---------------&-------------**************---******************-----------************
*************----&------------------------***************-*******************-------&----***********
*-************----------------@--&-------&****************-*******************----------&**---&*****
*-*************---------------------------*************************************------------------***
*-*************@------------------------&***************************************------&------------*
*-**************---------------&--------***************************************--------------------*
*---************-----------------------****************************************--------------------*
*---************-----------------------****************************************------------@---&---*
*--**************--------------------********************************************-&----------------*
*&-**************-&---------------&--*********************************************-----------------*
*--*************--------------------**********************************************-----------------*
*--*************----------------------********************************************&----------------*
*--*********--*-----------------------**************--****************************---------&-------*
*&-*********--**--------------&-------************----****************************---------&-----&-*
*-&*************-----------------------********---------*************************------------------*
*---***********-------------------------****-------&----*************************------------------*
*-&--*********--------@----------------------------@-----***********************----------&--------*
*--------**---&--------------------------------@----------*********************--------------------*
*-------@------------------&-------------&-----------------******************&--------&------------*
*-------**------------------------------------&--------------***************---&-------------------*
*--------*------@-----------&--------@-----------&------------***********--------------------------*
*--------------------&------------------&------------------------**********------------------------*
*----------------------------------------------------------------**********------------------------*
*---------------*-------------------------------------------------********-------------------------*
*----------------*-------------------------------------------------*******-------------------------*
*-------------------&---------------------------------------------********-------------------------*
*-----------------------------------------------------------&--------*****-------------------------*
*--------&---------@----------------------*--------&--------------------------------------@--------*
*-------------------------------&--------***------------------@---------------------------&--------*
*---------------------------&**--------******-----------------------------------------@------------*
*---------------------------********--*******----------------@-------------@-----------------------*
*----------------------***--*****************----------&@------------------------------------------*
*---------------------***********************--------------------&----------------------------@----*
*--------------------************************----------------------&---&---------------------------*
*--------------------************************------------@-----------------------------------------*
*-------------------*************************-&----------------&------------**-----------------&---*
*-------------------*************************-----------------------------****---------------------*
*----------------@--*************************---------------&&-----------**--*******---**----------*
*--&---------------*************************-------------------------------****************--------*
*-----------------**************************--------------------@----------*****************-------*
*--&-----------***************************--------------------------------*-*******************----*
*-------------***************************--------------------------------************************--*
*------------**************************----------------------------------***************************
*---&-------************************--------------------------&---------****************************
*-----------**********************----------&------&&------------------*****************************
*----------*********************-------------------------------------*******************************
*---------********************---------------&----------------------********************************
*--------********************-------------------------------------**********--**********************
*-------*********************-------------&-----------------------**********--**********************
*------**********************-------&-----------------------------*********---**********************
*------**********************----------------------------------@--********----**********************
*-----**********************--------------------------&--------**-*****-**----**********************
*-----*********************-------------@---------------------****-***--------**********************
*-&--*********************-----------------------------------*********--------**********************
***********************--------@-----------------------------*********----@-----******************-*
*********************-----------------------------------------********@----------****************@-*
********************---@------------&--&-------------@--------********-----------************&**---*
*******************------@------------------------------------****--*-----------**-*********-------*
******************------&------------------------------@@-----*******------------&-----****--------*
*****************--------------------&--&----------------------*****------&----------@--**---------*
****************--------------&--------------------------------------------------------***---------*
****************----------------@------------&------------------------------------------**---------*
****************------------------------------------------------------------------------**---------*
***************-------------------------------------------------------------------------**---------*
***************--------&-----@------@----&-------------------------------------&--------**---------*
****************-----------------------------------------------------------------------***---------*
****************---------------------------------------&--------------------------------*----------*
***************---------------@--------&-----------------&-------------------@--@------------------*
***************----------------------------------------&---------------------------&----------&----*
**************---------------------------------------------------------------&---------------------*
*************--&---------------@---********---------&-------------------------------&--------------*
*************--------&-------------**********-----&------------------------------------------------*
*************-------------------&*************---&-----------------@---&---------------------------*
****------&----------------------***************------------------------&---@----------------------*
*------------------------@------*******************----------&-&-----------------------------------*
*---------------@---------------*************************------------------&----------&------------*
*------------------&&------------*************************------------------------------------&----*
*----------------------&---------***************************--------------------------------&------*
*--------------------------------****************************------------------@----------------&--*
****************************************************************************************************
