********************
*------------------*
*------------------*
*---------@--------*
*------------------*
***********--------*
*----------------***
*----***************
*------------------*
*-------------$----*
*------------------*
********************
# MapInfo
# Pathfinding Test Map

