****************************************************************************************************
*-------****--------------------------------------&---&----------------******************-------****
*------******----------------------------------------------------------******************----&----**
*------*******---------------------------------@------&---------------******************----------**
*------*********-----------------------------------@-----------------******************-----------**
*-----****-*****---------------*----------&-----------------------*******************--------------*
*------**----------------------***-------&--------------------@---******************---------------*
*--------------------&---@------**--------------&----@-----------&**************--*----------------*
*--@-----------------@@--&--------&---------------------------------***********--------------------*
*------------------------------------------------&-@-@---------------*********&----------------&---*
*-----------**&--------------------------------------------@----------********-------@-------------*
*------------**----------------&-------------***----------------------******------------&----------*
*---------*-***----------------&------------****---------------------------------------------------*
*-------***-**----------------&-------------*****-------------------------------&&-----------------*
*-&-----***--------------------------@--@---****-*-@-----------------------------------@-----------*
*-@----***---------------@-----------------**********----------------------------------------*--****
*-----------------------------------------***********----------------------------------@----***-****
*--------------*---&----------------------************---------------------------------------*******
*-----------------------------------------************----------------------------------**--******-*
*---&---------------------------------@---************----------------------------------**********-*
*@------------------&--------------------************-------------------------------&***************
*-----------------&----------&-------&--&-***********----------------------------&---***************
*-------------*****-----------------------**********------------------------------&-****************
*--------------*****--------------------************--------------------@---@------*****************
*--------------****--------&-----------*************-------------------------------*****************
*--------------****-------------------***************------------@------------------*************--*
*--------------*****------------------****************----------------&------------************----*
*----------------***---------------********************-----------&----------------************----*
*-----------------**-----@----&***************************-**------------------------***--****-----*
*------------------***----------*****************************-&----------------------***---------@-*
*-------------------**------*--******************************----------@-----------***-&-----------*
*-------------------**-&----***********************************---&------@---&-----**--------------*
*--------------------------************************************----&-------------------------------*
*---------------------------***********************************--------------------------------@---*
*-----------------------------*********************************-&----------------------------------*
*---------@---------*--------**********************************---------------------@--------------*
*-----------------------@----***********************************-----------------------------------*
*---------------------*---***************************************----------------------------------*
*------&-------------**--****************************************----------------------------------*
*----------------------*******************************************-----------------------&---------*
**---------------------*******************************************---------------------------------*
****------------&------*******************************************--@---------------------@--------*
*******----------------******************************************-*--------@-----------------------*
********---------------******************************************-*--------------------------------*
********---------------*********************************************-******&-----------------------*
*********&-------------****************************************************--------&-------------&-*
*********------------&-*****************************************************-----------------------*
*********-------------******************************************************----@------------------*
*****-**-----@--------******************************************************-----------------------*
****------------------******************************************************-------&----@----------*
*----------------------*****************************************************-----------------------*
*---&------------------*****************************************************-----------------------*
*---------------------*******************************************************-----------------&----*
*----------------------********************************************************--------------------*
*-----------------------**********************************----******************-------------------*
*--------@---------------********************************-----*******************------------------*
*-------@-----------------*****************************--------********************@--*------------*
*-----------------&----------**************************--------*********************--**-&---------*
*---------------------------------***-*****************--------*-**********************------------*
*------------------@--------------------****************--&---------********************-----------*
*----------&--------@-----------------------************-------&------*****************-------@----*
*-@-------------&----------------------------*---@******--------------****************----------&--*
*-----------------&----------------**-*------*-----*---------&---------***************-------------*
*-----@------------------@--&-----*****-----&**----**-**--------------&****************------------*
*----------***--------------------******----****----**----*------------***************-------------*
*---------*****------------------*******----*******-**----*----------*****************-------------*
*--------*******------------------******-&&-***************----------****************----------*****
*-------*********----------------********---****************---------*****************---------*****
*-------*********---------------****************************-&-----********************--------*****
*&----****************----------*****************************----&********************--------******
*---***************-****--&-------********-********************----********************-------******
*--***************-------------&--*****************************-----**-****************-------******
*--***************----------------****************************--@------***************--------******
*--**************--------&--------***************************----------**************------------***
****************-------------&---***************************----------@*************-------------***
***************-----------&------****************************-----------************------------****
***************---------&--------&*********&--************----*---@-----************------------****
**************-------------&-------*******---************------&--------************-------------***
************-&--&----------@---------****---*************--&-&----------************-------------***
***********-&--------------------------**----***********-----@---------*************--------&-----**
***********---@---------------------------------********--------------**************---------------*
**********-------------------------------------********---------&----**************----------------*
**********--------@----------------------------&*******-------------**************-----------------*
**********---------------------------&-----------******-----------**************-------------------*
**********--------------------------------------*******----------***************------@------------*
**********----------------@&------&--------------*******---------**************----------&---------*
*********----------------------------------@----**********-@-----***************------&---&--------*
**--*****--------------------------------------***********------****************----------&--------*
*-----**--------------&---------------------@--******----------******-&*--******-------------------*
*--&---------------------&----------@---------*******----*----****--------******-------------------*
*--&----------------&-------------------------********-------*****---------*****--@-@--------------*
*----------------------------------------------*******---------------------***---------------------*
*---------------------------------------------******-------------------&----**---------------------*
*----------&-----------------------------------****----@-------------------*----------------&------*
*---------@---&-------------------------------****-------------------------*-----------------------*
*@------&---------------------------&-------@****-----------&--------------------------------------*
*--------------------------&---@--------*-----***--------------------------------------------------*
*----------------------------------------***-****--------------------------------&-----------------*
*-------------&-----------&--------------********---------------------------------&----&@----------*
****************************************************************************************************
