************************************************************
*@-------------------**************-------&---------------**
*---------------------*************----------------*****---*
********-------------***************---------------******--*
*********------------*****************---------------**---**
**********-------****-*****************---------@-------****
*********------************************-------@---*****-****
***********-*--*************-*****----------------**********
*---**********************-------------------*-*-*********-*
*------******************------------------*****************
*----------**************-------------------****-*******-*-*
*----------*****-****--------------------------*--****-----*
*-------------------*------------------------------****----*
*-----------------------------------------------------@----*
*--------------------------------------------------&-------*
*---&--------------------@**------------------------------@*
*-------------------------***---********-------------------*
*-----------@---------*-*****************-----------------&*
*-------------------**********************-----------------*
*------------------************************----------------*
*-----------------***********-******----**----------------@*
*---------------@-***********--***-------------------------*
*-----------------*************---**------------------@--***
*------&-----&---***************-******-----@----------*****
*-------------------**-****************----------------*****
*---------&--------**--****************-**---&---&-----*****
*--------------*************************-------------*******
*-------******************************--------------********
*-----***************-------********--------------------****
************************************************************
