****************************************************************************************************
**************------------------********************************--------************-------------***
***************----@------------********************************--@-----**********-----------------*
***************------&----------*********************************-------***********-------@--------*
****************--@--------------*********************************--******************-------------*
******************---&------------*********************************-******************----------@--*
******************---------------*************************----***--******************--------------*
******************----------------**************************-------**********-----***--------------*
******************---&-----------***************************--&------**---**--------&--------------*
******************---------------***************************-------------&*----------------&-------*
******************--------------*****************************---&----------------------------------*
******************-------------******************************--------------------@-----------------*
****--**************&--------*-*****************************---------------&-----------------------*
***----****************-----*******************************----------------&--------------------@--*
***----****************************************************-----------------------*----------------*
*-*------*************************************************&-------------&---&-----*----------------*
*----@---*******************************--****************&----&&--------&-------------------------*
*-------*******************************----***************-----------------------------------------*
*-------*******************************------*--*********------------------------------------------*
*------********************************---------*****-**-------------------&-----------------------*
*-------*******************************------------------------------------------------------------*
*--------******************************-----------@---------@---------------------------&----------*
*---**----***************************--------------------------------------@-----------------------*
*--***---***************************-------------------&-------------------------------------------*
*---**---***-**********************---------&-------------------------&---&------------------------*
*---------*----******************--&-------------------------@-----------------------&--&----------*
*--------------*****************-----------------&-------------------@&----------**-------------&--*
*------------------***********----------------------&-------&--------------********----------------*
*-------------------*********----@--------------------------------------******---------------------*
*-----------------**************----&----------------------------------******----&-----------------*
*-------------------@**------***-----&-----------------&-------------********-----------------@----*
*-&-------------------------****----------------&-------------****-*************----@---------@----*
*---&------------&----------***------------------------------********************------------------*
*--@---------------------------------------@---------------@**********************-----------------*
*------&-----------------------------------------------------**********************----------------*
*-------------------------------------------------------&---***********************-------@--------*
*-------------------------------------------------------@---************************--------------@*
*&-----------------------------------------------------------**********************-@-------------&*
*------------------------------------------------------------***********************---------------*
*---------------&--------------------------------------------***********************-------------&-*
*-----------------------------------------&-----------------@************************--------------*
*------------------------------------------------------@-----*************************------------&*
*----&------&--------------&--------------------------------**************************-------------*
*-------------------------------------&----------------------*********************-----------------*
*-----------------@--------------&-------------------&@-&----********************------------------*
*---------------------------------------------------------------**-*************---------&---------*
*------------@----------------&-----------------------------&------************-@------------------*
*------------------------------------------------------------------************--------------------*
*------------------------------@------------------------------&---************---------------------*
*-----&-----------------------------------------------------------************--&---------@--------*
*------------&--------@--@----------------------------------------***********----------------------*
*---------&----------&---------------------------------------------*********-&---------------------*
*------------@-----&--------------------------------------------**********@------------------------*
*-------------&-------------------------------&----&----------&--*********-------------------------*
*--------------------------&----------------------------&-------&********--------------------------*
*---&-------------------------&----------------------&----@&-----***-------------------------------*
*----------&---------------------------------------------------&--*--------------------------------*
*------------------&-----------------&------------------&--------------------&----&----------------*
*------------------&-------------------------------------------------------------------------------*
*-------&-----------------&--------------------------------------@------@----&---------------------*
*----------------------------------------&---------------------------------------------------------*
*-------------------------------------------------------------------------------------------&------*
*----------------&------&-----------------------@-----------------------------&&-------------------*
*------------@&---------------&-------------&-----------------@------------------------------------*
*-------------------&-------&----------&------------------------------------------&----------------*
*---&-------------------------------------------&---&------------------------------&---------------*
*--------------------&&----------------------------------------------------------&-------------&---*
*-------------------&-----&-@------&-------------***-------&-----------@---------------------------*
***---------------------------------@&------********--------------@@-------------------------------*
****-*---------------&-----------------**************----------------------------------------------*
******--------------------------------*****************--------&----------@------------------------*
******-------------------------------*******************@&****-------------------------------------*
******-----------------------------****************************------------------------------------*
******---------------@------------*****************************------------------------------------*
******--@------------------------**************************-**-----@&------------------------------*
******--------&------------------**************************---------@------------------------------*
******---------@--@-------&------**********************--**----------------------------------------*
*******----------------------&-***********************-----------------------------&------&--------*
*******------------------------***********************----------------------------------------*----*
*******---------------@--------***********************--------------&-------------------------******
******--------&-----------------*********************---------------------@--------------&---*******
*****----------------------------********************---&---------&------------------------*********
*****-----------------------------******************-------------------------------------***********
*****--&--------------------@--&-******************--------------------------------------***********
*****----------------------------*******************---------&-----------------------&--************
*****--------------------&------********************--------------------@--------------*************
*****--&------------------------********************-----------------&---------&--------************
*****---------------------------*******************-------------------&----------------*************
****--------------@-----------**********************----------------------------------@*************
**-----------------&----------*********************-------------&----------------------*************
**--------&------&------------********************-----&-------------------------------*************
**----------&-----&@----------*********************--------------------&-@------------**************
**----------------------------*********************---@---&---------------------------**************
*-----------------------------*********************-----------------------------------**************
*-----------------------------***********************---------------------------------**************
*-------&--------------@------&*********************----------------------------------**************
**&-&------@-------------------********************-------------------------------@---**************
**-------------------------------*****************-----------------&---------------------***********
***--------------&---------------&****************--@------@-----@-----------------------***********
****************************************************************************************************
