****************************************************************************************************
********************-&********************-------------&-@---------**************************------*
*******************************************------------------------**************************------*
*-******************************************-----------------------*************************-**----*
*--****************************************------------@----------******************************---*
*&---****************************************---------------------*******************************--*
*----*****************************************-&---------------&---******************************--*
*----*****************************************--------------&----------**************************@-*
*----****************************************-----------@---------------**************************-*
*---****************************************----------------------------------*************-********
*---*****************************************-@----------&---------------------***********&-********
*---*****************************************-----@------------------------------*********--********
*---*****************************************------&------------------------@------********-********
*----****************************************-------&---------------&-------------@-***********-*--*
**----************************************--------------------&-------&---------------**-*-***-----*
*-----**********************************-------------------------------------------------***-------*
*-----*********************************---------------------@------------------@-------------------*
*-----*******************************----&-@-----&---------------@-----------------------------&---*
*-----******************************-----------&-&-------------------------------------@-*---&-----*
*----******************************---------------------------------------------&------&-----------*
*-----****************************-----------------------------------------------------------------*
*-----***********************-------------------------------------------------------@--------------*
*-------*******-**********-**---------&---------------------------------------------@-----&--------*
*-----------------**-**-------------------@--------------------------------------------------------*
*-------------------------------------------------------------------------------@------------------*
*----&---------------*----------&-------------------@----------------------------------------------*
*-------------------**-------------&-------------&--------------&----------------------------------*
*---------&-------------@-----------------&----&---------**--------------------------------------&-*
*------------&--&@---------------@------------&----------**-----------------------------@----------*
*---@------------------&-------&--------------------------**--------------------------------&------*
*------------------***---***--------&-----------------------------------------------------&-&------*
*-------------@----*---******--------------------------------------------&-------------------------*
*----------------------*******---------------------------------------------&--------*****--*-------*
*------------------&---*********--------&------@--------------*-------------------**********-------*
*----@---------------***********--------&------&------------**----@---------------************-----*
*---------------&---*************-----------------&---------****------------------************-&&--*
*--------------------*************---------------------------****----------------*-*************---*
*--------------------**************---------------------------**------------------************-**-&*
*---------------------***************-------------------------**------------------****************-*
*---------------------****************-------------------------*-----------------*******************
*-----------&----------***************--------&-----&---------@------------------*******************
*-----------------&----***************-------------------------*----------------********************
*----------------------***************-------------------------*----------------********************
*----------------------**************------------------------------------------@********************
*----------------------**************------------------------------------------@********************
*----------------------*************-------------------------------------------*********************
*----@-----------------*************------------------------------------------**********************
*----------------------*************----------------@---------&-----------@---**********************
*--------------------&-*************-----------------------------&------------**********************
*---------------------**************------------------------------------------**********************
*------------&----&--**************-@@----------------&------------&----------**********************
*-------------------**************--------------------------------------------**********************
*-------------------**************---&----------------------------------&-----**********************
*-------------------************----------------------------------------------**********************
*------------------*********---------@-----------------------------------------*********************
*------------------********----------------&-&-----------------&---------------****&****************
*@--------------**********------------------------------&---------------------------****************
*------&--------**********---------------------@------&------------------------------***************
*---------&-----*-********----------------------------------------------------------****************
*---------&--------******----------------------------------------------------------*****************
*-------------------*****---&--&-------@---@--------------------------------------******************
*-------------------*****-------@-----@------------------------------------------*******************
*-------@---&-----------&----------------&-------------------------------&------********************
*------------------------------------------------------------&---------@-------*********************
*-------------&--------------------------------------------&-------------------*********************
*--&---------@--&--------------------------------------------------------------*******************-*
*------------------&--------------------&------&--&----------------------------**--***************-*
*----------------------------------------------------------@&-----------------********************-*
*-------------------------------**-***--------------------------------***-----&*******************-*
*--------------------------***-********----------&---------&----------********---*******************
*-------------@----------**************----------&---------------------******----*******************
*------------------&----***************---------------------------------******---*******************
*-------&--------&------****************---------------------------------****-----**-***************
*-----------------------****************----------------------------------****-*-***-***************
*-------@----------------***************--------------------------------****************************
*&------------------------***************--------------------&-------********-**********************
*-@----------@-------------**************---------------------------*********-**********************
*----------------------------**************----------------@--***--*********************************
*-----------------------------*************-------------------**************************************
*-------------&&--------------*********-***-------------------**************************************
*-----&------------------------*******************-**-----------**********************************-*
*-----------------&------------******************--**-----------**********************************-*
*-----------------------@------**********************------@----***********---********************-*
*------&-----------------------***********************--------**************---******************--*
*-----------------------------@******************---**-------*************------******************-*
*-----------------------------************************----****************-----****************----*
*-----------------------------********************************************------***************----*
*------------&----------------*********************************************-----*************------*
*&----------------------------********************************************-----*****--*****--------*
*------------------------@----*******************************************-----****----****---------*
*----------------&-----------*******************************************-------*-------------------*
*---------------------@------******************************************----------------------------*
*--------------&--@-----------************************************-***-----------------------------*
*-------------@---------------**********************************----*------------------------------*
*------------------------------**-*****************************------------------------------------*
*------------------------------------*************************------------------------------&------*
*-----------------------------------**************************-------------------------------------*
*-----**----------------------------***************************------------------------------&-----*
*--*-****------------&--------------***************************-----*---*-------@------------------*
****************************************************************************************************
