****************************************************************************************************
*--------*************************-----&@---------&----&---------------*********************-------*
**---******************************-----@------------------------------**********************------*
***********************************-----&---------------------------@--**********************------*
***********************************---------------------------&@@------**********************------*
***********************************------------------&-----------------**********************------*
**********************************----------------------&-------------***********************------*
*********************************-------------------------------------***********************------*
*********************************--@---------------------------&-------***********************-----*
********************************-----------------------------&----@-----**********************-----*
*******--**********************-----------------&-------&----------------**********************----*
*******--**********************---------&---------------------@------@----********************-----*
******---**********************&----------------------------------*------*-*******************-----*
****-----***********************------------&----------------------*---****-******************-----*
*****----***************************------------------&--@----------*-***---*****************---*&-*
*****---*****************************----****----@&-----------------*--------**-********-***-------*
****----&*****************************--*********-****-------------@------------********--@--------*
****-----****************-************-****************-------------*------------*******--------@--*
****-----****************-*--***************************---------------------------*****-----------*
*****----**--************-----**************************@-------------------------******-----------*
******---**--***********----&***************************----------------------------&--------------*
*******-**---***********-----****************************---&---------&---------------------------&*
******---&-***---------------****************************----------------------&-------------------*
******---------------&------*********************************--------------------------------------*
*******---**----------**-----***********************************--------------------------&--------*
********----------------------************************************---------------------------------*
*********---------&-----------**---********************************--------------------&-----------*
*********&-@-------------&---**-----*******************************-----@---------------&--------@-*
*********-------------------***------******************************--------&-&----------@----------*
**********---------------------------@*****************************------------------------@-------*
**********&-&--------------------------**************************-----------------------@----------*
*********-------------------------------*************************---------------------------------**
********------------------------------@--************************--------------------------------***
*********--------------------------------***********************--------@------------------------***
*********-------------------&--------------*********************@--------------------------------***
**********-------------------@--------------*****************--&-------------------&--------------**
********--------------------------&---------****************--------------------------------------**
********-------------------------------&------***********------------------------------------&-----*
*********---------------------------------------*-**-----------------------------------------------*
*--*****-&-----------------------------------------------------------------@----&------------------*
*---****---------------------@---------------&-----------------------------------------------------*
*---*****-------&------&------------------------------&------&-------------&-@---------------------*
*---****-------------------------------------------------------------------------------------------*
*--*****---------@--------------------------------------------------------------&------------------*
*---*****---------------------&-----------------@-&--&------------------&------&----@--------------*
*--******--------------------------------------------------------------------------------&---------*
**********---------&---------------------@----------------@---------------------------------------**
**********-------------------------@----------&------------------------&---------------------&----**
**********----------------------------------------------------------------------------------------**
**********----------------------------------------------------------------@------------------------*
***********-------&----------------------&---------------&----@---------------------------------@--*
************---------------------&----------------------------------------------------------------**
*************------&------------------------------------&-----------------------------------------**
************---------------------------------------------------------------------------------------*
***********--------&---&---------------------------&------------@----------------------&--&--------*
***********---&-----@------------------------------------------------------------------------------*
**********----&------------------------------&-----------------------&----&------------------------*
*********@-&*-------------------------------------------------@------------------------------------*
********-&--**---------------------------------------------------@--------&------------------------*
*******-----**-----------------------&-----------------------&-------------------------------------*
***------------&-----&------------------@----------------------------------------------------------*
*------------------------------------------------@-------------------------------------------------*
*-------------&---&****--------------------&-------------------------------------------@-----------*
*----@---------********------------------------------&---------------------------------------------*
*---------------*******---------@--------------------------------------&--------@------------------*
*-@--&-------&--*******---------------------------&-------&---&------------------------------------*
*-------@-------********&-----------------------------@--------&-----------------*-----------------*
*----------------*******--------------------------------------------------------**-----------&--&--*
*---&-------------******------------------------@-------------------------------**-----------------*
*------&-----------******-------------------------------------------------*********---------------&*
*-----@------------&****---------------------@-------&------&------------**********----------@-----*
*--------------------****-----------------------------------------------***********----------------*
*----@---------------****----@---------&-@-----------------------------************--------@-------*
*---------------------**----------------&---------------------**------**************---------------*
*-&-------------------*-------------------------------------*****-----*************----------------*
*------------------&-***-----------------------------------*******---**********---@----------------*
*-@----------&----@--***----------------------------------*********--**********--------------------*
*-----------@--------*------------------------------------**********-***-*****---------------&---***
*----------------&-------------------------------------*******************--*--------------------***
*-----------------------------------------@--------**********************------------------------***
*------&----------------------------------------@************************--------------------*******
*-----------------------------------@-------------**********************---------------------*---***
*-------------------------------------------------**********************-----&---------------*---@-*
*-------------&----------------------------------&--******************----------------------**-----*
*-----&----------------------------------------------***************--&---------------------**-----*
*----------------------------------------------------*************-------------------------****----*
*----&------------------------------------------------************-------------------------****-@--*
*-&--------------------------------&------------------***--***---&--------------------------*-*----*
*------------------------------------------------------&---**---@-----------------------------**--@*
*---------------------------------------@&-----------------**-----------------------&---------***--*
*--------------------------&----@--------------------------------------------------@------------*--*
*-------------------------------------&--&--------------------------&--------------&---------------*
*------------------------------------&--------&---------&------------------------------------------*
*-&--------------&-----@-@--------------------------------&----------------------&-----------------*
*-----------------------------------------&--------------------@------------------------------&----*
*-----------------------------------------&----------@-------------&-------------------------------*
*-------------------------&------------------------------&---------------------------------------@-*
*------------&-------------------------------------------------------------------&---------@-------*
*------------------------------------------@-------------------------------@-----------------------*
****************************************************************************************************
