****************************************************************************************************
*---&-----@----------------********----***************************---------*******-------------&---*
*-----@--&@----------------*******------**************************----------*******-------------&--*
*--&---------------@-------*****-*--&---*-*-**********************----------*******------**--------*
*-&-----------------------********-----------*******************------------****-**---*****--------*
*--------------------------***-----------&---*******************-----------&****************-------*
*--------------------------------&---------&--******************-------------***************-------*
*----------------------------------&---------*******************------------****************--*----*
*-------&------------------------------------*******************------------*******************----*
*------&---------------&-----&----------------******************-----------********************----*
*-------------------@-----------&-------------***********************-----**********************---*
*----------------------------@----------------***********************----***************************
*---------------------------------------------&*****************************************************
*---------------------------------------------******************************************************
*----&--------&-----------&---------------------*********************--*****************************
*-----------------------------------------------@*******************---*****************************
*----@-----------------------@&------------------@-*****************--******************************
*-------------------------------&-------&----------*************************************************
*--------------------------------------------------*************************************************
*---------------&---&-------@------&--------------&*-***************-*******************************
*---------------------------------&-----------------*-**************-*******************************
*--------------------------------------------&--@-----**********************************************
*-&------------&---------------------------------------*********************************************
*-------------&-----------------------------&-------@--**-******************************************
*-&-------------------------&------------------------------*****************************************
*-@----------------&----------&-------------------------@---***-************************************
*-----------@---&--------&----------------@----------------------***********************************
*---------------------@-&---@--------@---------------------------***********************************
*-------------@---------------------------------------------------**********************************
*----------------------------------------------------------&-------*********************************
*--------------------------&----------*----------------------------*********************************
*---------------@--&----&------------*****---------------@--------&-********************************
*----------------------------------@******----------------------------****************************&*
*------------&--------@-------------******----------------------------****************************-*
*---@-----------------&-------------*******----------------------------**************************--*
*----------------------------------********-----------------------------*************************--*
*------------------------------&---*********--------------&-----------@@-************************--*
*------@--------------&------------********----------------------@--------**********************---*
*--------------------------&--------*****------------------------@--------*********************----*
*------------------------------------***-----------@&---@-----------------********************-----*
*-------------@--&---------**----------*-----@----------------------------********************-&---*
*-------------------------@-**-------------**--------&-------------@-------******************------*
*--------------------------**--------------**-----------------------------********************-&---*
*--------------------------**-------------***--------------@-------------********************------*
*---------------------------*-----------------------&---------------------*******************------*
*-----------------------&-------------&-------@---------------------------*******************------*
*----------------------------------------------------&------------@--------*****************-------*
*---------------------------@--------------------@&-----------------------@*****************-------*
*-----&---------------------------------------------------------------------***************--------*
*---------------------------------------@------------------&----------------**************--@------*
*-------------------------------------------------&---@&--------------------**************-------&-*
*---------------------&--@*---------------------&--------------@------------**************---------*
*------------------------***------&---------------------------------------&-*************----------*
*---@--@----&-------------------------------@-&-------------@----------&----*****-******-----------*
*-------&--------------------&----------------------------@----------------*********---------------*
*-----------&-----&----------------------------@-------------------------*********-----------------*
*--------------------&----&--@----------------------&--@----------------*********-@-------------@--*
*-------------------------------&---------------------------------------*********------------------*
*-----@--------------------------------------------------------@------------***----@---------------*
*---------------------**-----------------------&----------------------&---*--*---------------------*
*--------------***-********-----------------@----------------------------*****---------------------*
*-------------**************-----------------------------------------&--********-&---------------@-*
*------------***************-----------------&--------------------------********-------&-----------*
*------------****************----------------------------------***------***********--------------&-*
*------------******************--------------------------------*****---*************---------------*
*---@-----&--******************--------------------@----------******--**************---------------*
*----------&********************-----------------@-----------******---***************------------***
*-----------*********************-@------------------------&-******---******************--------****
*----------***********************--&-----------------&&----*******---******************-------&****
*---------************************--------------------------*******---******************--------****
*--------***************************-------------------&---********---******************--------****
*--------***************************-----------------------******************************-------****
*------*****************************-----------------------*****************************-------&****
**-----******************************---------------------******************************---------***
***----******************************------------****-*-&*****************************----------****
***----******************************-----------**************************************----&----*****
*-------*****************************-----------**************************************&--------*****
**------*******************************--------******************************************------*****
**----***********************************--*********************************************************
***--***********************************************************************************************
***--***********************************************************************************************
****************************************************************************************************
*****************************************-**********************************************************
****************************************--**********************************************************
*********************************-*-***--&*******-**************************************************
********************************----***------------*************************************************
**************************---**------*---------------***********************************************
*************************-------------------------------********************************************
********************-------------&-----------------------*******************************************
**************-------------------------------------------*******************************************
**********-----&--------------&---------------------------******************************************
********------------------------------------------------&-----**************************************
*******---------------------------------------------------------************************************
******---------------------------&--------------------------------**********************************
*******------------------------------------------------------&-----*********************************
******---------------------&---&--------------------&&-----&----------******************************
******------------------------------------------------------------**-*******************************
*****-----------------&------------------------------------------***********************************
***----------------------------------------------------------&--&***********************************
****************************************************************************************************
